10,10,10,10,10,10,10,10,10,10,10,10,10,10,10,10
10,2,0,0,0,0,0,11,0,0,0,0,0,0,3,10
10,1,10,10,10,10,10,10,10,10,10,10,10,10,1,10
10,1,10,10,10,10,10,10,10,10,2,0,0,0,5,10
10,1,10,2,0,3,10,10,10,10,1,10,10,10,10,10
10,1,10,1,10,1,10,10,10,10,1,10,10,10,10,10
10,4,0,5,10,1,10,10,10,10,1,10,10,10,10,10
10,10,10,10,10,4,0,0,0,0,5,10,10,10,10,10
10,10,10,10,10,10,10,10,10,10,10,10,10,10,10,10
